11111111
10010101
11000101
11101101
11100001
10001111
11010001
10000101
11111111